##########
#        #
# ########
# #      #
# # ######
# # ######
#     ####
##### ####
##### ####
#####     
##########
##########